%%%%%%%%%%%%%%%%%%%%%%%
%                     %
%P...%    %%     $....%
% .%%.   %% %%   .%%. %
%%....% %% G %%  .... %
%      %% .o. %%      %
% ..  %%       %%  .. %
% .. %%         %% .. %
% %.......%  %......% %
%%%%%%%%%%%%%%%%%%%%%%%
