%%%%%%%%%%%%%%%%
%..............%
%%....%........%
%%%....o.%%....%
%....o%%%...%..%
%..%%.%%.......%
%.o...%...%.%..%
%%%.%....%.....%
%....%.G..%...%%
%..%...%%....%%%
%.........%%%..%
%..%..%..%.....%
%..%%..%P%%....%
%%%%.....%....%%
%....%..%o%..%%%
%.....%........%
%...%o.%%......%
%%...........%.%
%...%..%..%....%
%o.......%%%%..%
%%%..%........%%
%...%..%.%.%G.%%
%%............%%
%...%..%......%%
%%%%%%%%%%%%%%%%
