%%%%%%%%%%%%%%%%%
%...............%
%........%...o..%
%....%.P..%%....%
%..%..%.....%%..%
%..o%.o...%....%%
%%%.%%....%%o..%%
%...%.....%..%.%%
%......%.%.....%%
%.%...%G...%...%%
%...%%...%......%
%%....%%...%....%
%..%%..G%...%%..%
%%...%..%%o...%.%
%.......%..o....%
%.%....G..%.....%
%..%%%.G........%
%....o.o...%..%.%
%..%%...%%o.....%
%...o......%.%..%
%....%%.%.......%
%..o.......%o%.%%
%.....%.%.o.....%
%...%.....%%.o%.%
%.....%..%.%%%..%
%%%..%%%...%....%
%%%%o...%....%%%%
%..%%.o....o%%%%%
%%.%....%%.%%%.%%
%o.%%%%%.......%%
%%.%%%..o.......%
%.o.......%oooo.%
%%%oooooo%oooo.o%
%%%%%%%%%%%%%%%%%