%%%%%%%%%%%%%%%%%%
%o...............%
%%......%.o......%
%%%..%...%%%....%%
%%%%...%....%...%%
%%%.....%.......%%
%o..o.........%..%
%.%%.%..%..%.....%
%...Go.%oo..%..o.%
%.o.%............%
%%%%%%G%.%....%..%
%...%.......%...%%
%%..............%%
%..o.%..%.%%%.%.%%
%..%.............%
%%..%.%%P....%o..%
%%%..Go...G...%..%
%..%%.....%.%....%
%%...%......%%...%
%%%.....%...%....%
%...%.%.%%...%..%%
%......%%%%.o..%%%
%..%%%...........%
%%.......%%....%.%
%...%........%...%
%.....%..%.%....%%
%%.............%%%
%....o%........%%%
%%%%%%%%%%%%%%%%%%
