%%%%%%%%%%%
%.........%
%..%.%..%%%
%.......o%%
%%........%
%%%.%...%%%
%....%..G%%
%........%%
%......%%%%
%%..%.%G.%%
%%%o.....%%
%..%%%%...%
%........o%
%.....%..%%
%%%..o..%%%
%...%.%%%%%
%.........%
%...%%%G.o%
%%%%....%%%
%....o%...%
%.........%
%o........%
%.P.......%
%%%.......%
%%..%%%%..%
%..%.%%..%%
%...%%....%
%%........%
%%%%%%%%%%%
