%%%%%%%%%%%
%.........%
%.%.%%.%..%
%.....G.%%%
%....%...%%
%o%%%...%%%
%%..%%....%
%...%.....%
%.....G...%
%o..%.%...%
%..%P.%%..%
%%%...%..%%
%..o.....%%
%o.%%....%%
%.........%
%.%.o..%..%
%.....%...%
%..%%.....%
%.....%GG.%
%........%%
%%%%%%%%%%%
