%%%%%%%%%%%%%%%
%.............%
%...%%o%.....G%
%.%%.........%%
%.........G...%
%%.%%...%.%...%
%...........%.%
%%G%%%....%...%
%....o...%....%
%%%......G%%.%%
%..%..%.%.....%
%....P....%...%
%%..%...%...%%%
%........%...o%
%%..o%.....%..%
%%%%%%%%%%%%%%%
