%%%%%%%%%%
%....o...%
%.....%..%
%......%.%
%.%......%
%....%%..%
%...%...%%
%...G%.%%%
%o%.....%%
%.oo%%%.%%
%...%%%%%%
%...%%%.%%
%..%....%%
%%%...%..%
%......G.%
%%%.%%%.%%
%%..G....%
%..%..%..%
%.%......%
%...%....%
%%%...oG.%
%..%....%%
%o..%P.%%%
%....oo..%
%..%%.%..%
%%%o...o.%
%%%%....%%
%....%...%
%%%%%..%%%
%.......%%
%...o...%%
%%%%%%%%%%
