%%%%%%%%%%%%%%%
%............o%
%%G..%%.P...oo%
%o.%.....%....%
%%.....%%%%%.%%
%..%%.........%
%%%..%.o...o..%
%.........%...%
%............%%
%%%..%...%....%
%..%..........%
%..%%..%..%%%%%
%..%G....%....%
%..%%G..%%%.G.%
%%%%o%%%....%%%
%%%%%%%%%%%%%%%
