%%%%%%%%%%%%%%%%%%%%
%..................%
%%o%...o%.%..o%.%..%
%...%G....%%....%%.%
%%....%%.%%.....%..%
%.....o...%%......%%
%%%%%..G.%%..%%.%..%
%...%%.%....%......%
%...%......o..o%..%%
%%%.........%..G...%
%...%.%%%%.%%%.%.o.%
%..%...%%..o.....%%%
%o.....%%%G....%%%%%
%..o.%......%......%
%%.....%%..%%%..o..%
%.....%.....oo.%...%
%......%......%%%..%
%%o%%....%%.....%%%%
%%%...%.%.%%.......%
%.........%o..%%...%
%%%%.%....%%%%%..%%%
%%%....%..%%%.P...%%
%%...%%....o%%...o%%
%%%%%%%%%%%%%%%%%%%%
