%%%%%%%%%%%%%%%%%%
%...............o%
%.%%.%%...%%.Go.%%
%......G......%..%
%%.o...%....%....%
%.......%%.%..%.%%
%....%%......%...%
%..%...%.%.%%...o%
%...%.....P......%
%.....%.....%%...%
%%....G..%%......%
%%%%%..%.....%..%%
%o............%.o%
%.....%.%....o.%.%
%........%%......%
%..%......%%%....%
%%%..%%...%......%
%%..%....%...ooo%%
%%%%%%%%%%%%%%%%%%
