%%%%%%%%%%%%%%%%%%%
%....o............%
%....%%%..%%....%%%
%.%%....%........%%
%...%%%........%..%
%...%%..%...%.%%%.%
%.%.%.............%
%......%%%.....%.%%
%%....%...%%.....o%
%o.....%.......%..%
%.o....%%..P..%G..%
%..%..%%.o...%..%%%
%...%...%%...%%%..%
%%.o...G.o%..%..o.%
%o%....o%%%%o.....%
%...%%%...%.....%%%
%%%........%..%..%%
%%..o%%.....%%...%%
%%%...%%.%.....o..%
%%%%%%%........%.G%
%...........%.....%
%%.%..%...%..%..%%%
%......%...o.%%%..%
%%..%.......%%....%
%......%........%%%
%%%%.G..%.%......%%
%...%..o........%%%
%%.....%..%.......%
%........%%%......%
%....%..%.........%
%%......%%.......o%
%%%%%%%%%%%%%%%%%%%
