%%%%%%%%%%
%..o..o..%
%...%....%
%....%...%
%....%%..%
%.%%.%..%%
%.....%.%%
%%%...%%%%
%%%%..%..%
%.o...%%.%
%o.%o.%..%
%%..oo.%%%
%...o...%%
%..%%G..%%
%.%.....%%
%..%.%.%%%
%........%
%.o.%%%..%
%.%.....P%
%.%%%....%
%.%......%
%o....%%.%
%..%%...o%
%.%.o....%
%...%..%%%
%%%%..%%%%
%.......%%
%.%%%%%%%%
%..%%%...%
%.o....%o%
%%....%..%
%%%......%
%%%%%%%%%%
