%%%%%%%%%%%%%%%%%
%........oo.....%
%%.%....o.%..%..%
%....%..%......%%
%o....%%..o...%%%
%....oG...o..%%%%
%.%...%..%.%.%%%%
%.%%...%....%%..%
%.%.......%.....%
%...P%.......%..%
%%%.%%%%%.....%.%
%.o....G........%
%%.%%%%o%.%....%%
%....%%%...%%%.%%
%%%%........G..%%
%%%%%%%%%%%%%%%%%
