%%%%%%%%%%%%%%%%%%%%
%.........o..oo....%
%..%%%%....%%%%%%o.%
%%%%%.%%%....%.....%
%.....%.....o..%%..%
%%...%......%....%.%
%..G.....%%%.o.....%
%%%%....%......%%%.%
%%.....%..o..%.....%
%%%..%...%%G....%.%%
%.%%....%....%..o..%
%.%...%oo...%%%.%..%
%....oo...%%.......%
%%%.%.%o.......%...%
%...o......%%......%
%%.P.%.%..%.....%..%
%..%%..G...%....%%%%
%%....o......%..%%%%
%..%%%%.%%%.%......%
%%%......%...%.....%
%....%.........%...%
%......%...%......%%
%..%........%G.....%
%%%....%....%%%%%..%
%%%%%%%%%%%%%%%%%%%%
