%%%%%%%%%%%
%..o.....%%
%.%%%%.o%%%
%.........%
%%.....%..%
%....%....%
%.......%.%
%..%......%
%%.%%...o.%
%..%....%.%
%.%..%....%
%.........%
%.%%G%o%..%
%....%%%%.%
%.%%%%%%..%
%.%%G...%%%
%%%.....%%%
%%%%....%%%
%......%.%%
%%..%...%%%
%..%%%%...%
%......G..%
%.....%%..%
%%%G%%..%%%
%..o.%%..%%
%%%o.%%%P.%
%%%%..%...%
%%%....%%.%
%%..%....o%
%...oooo%o%
%%%%%%%%%%%
