%%%%%%%%%%%%
%..........%
%.%.%%%%.%.%
%.P...%....%
%.%.....%%.%
%.oo.o.....%
%%..%....%.%
%..........%
%%.......%%%
%..%%G..%.%%
%....%.%.o%%
%.....G.%..%
%.%.%G...%o%
%..........%
%%%%...o...%
%%%%%..%%..%
%..%.......%
%..%%%.%%%%%
%.%%...%%%%%
%...%..%%%%%
%....%.....%
%%%....o...%
%.......%.G%
%%%%%%%%%%%%
