%%%%%%%%%%
%........%
%....%...%
%........%
%..%o%...%
%.....%%%%
%%.P%...%%
%.......%%
%%%.....%%
%%...%..%%
%...o...%%
%o....%%%%
%.%..%%%%%
%.G%...o%%
%........%
%.o%..%%.%
%....%...%
%.%..%%G.%
%....%..%%
%..%%%%%%%
%..o.%..o%
%.o....%%%
%...%....%
%%%%..%..%
%%%..%..%%
%.....%..%
%%%......%
%....%...%
%%%%%%%%%%
