%%%%%%%%%%%%%%%%%%%
%............o...%%
%%%..G.%..%..%.%o%%
%........%..%.....%
%..%%.....%.....%%%
%.....%....o..%..%%
%.%%G...%%..%%.o.%%
%..%%..........%.%%
%..%.....%........%
%%%%%%%%.%%%...o%%%
%....%...%...%...%%
%%%........%...%..%
%%%%.%.o..%...%o..%
%.....%%%.%%..o...%
%%%%......%..%.%..%
%%..............%%%
%%%o..%%%%........%
%.....Go.....%.%..%
%...%%o...%%%.....%
%..........%.....%%
%.............GP..%
%%.%.%%%....%.....%
%.........%......%%
%%%%%%%%%%%%%%%%%%%
