%%%%%%%%%
%.....%.%
%..G....%
%%.....G%
%.......%
%....o%.%
%.G.....%
%.....%.%
%.%..%.%%
%..%%%P.%
%......%%
%%...%.%%
%%%%%%%%%
