%%%%%%%%%%
%.....%.%%
%%%....G.%
%..%%..%.%
%........%
%........%
%.%......%
%.o....%.%
%%.%..%%.%
%..%%.%.P%
%%..%%..%%
%........%
%....%...%
%......%.%
%%.......%
%....%..%%
%.....%.%%
%%%%%%%%%%
