%%%%%%%%%%%%%
%....%%.....%
%%.....%%...%
%..%..%..%..%
%..G.....%..%
%...G.o...%.%
%...........%
%...%%o..%.%%
%%..%..%.%%G%
%...%o..%..o%
%.....%%...%%
%.....P.....%
%..%....%.%.%
%%.%.....%..%
%....%......%
%%%%%%%%%%%%%
