%%%%%%%%%
%....%.%%
%....%P.%
%......o%
%..%....%
%.%%.%..%
%.%..%..%
%.%%..G%%
%.%G....%
%.G..%.%%
%.....o.%
%%.%.%%.%
%......%%
%%%%%%%%%
