%%%%%%%%%%%%
%..%.....o.%
%o%...o....%
%.%..%G....%
%..........%
%....o...%.%
%%%...%%%..%
%.%........%
%...%o..%%.%
%%%%%......%
%.%........%
%..%.%.....%
%...%%%o%G.%
%...%.%..%.%
%.....%%...%
%.......%P.%
%.%%..%....%
%......%%..%
%..%%......%
%%%%%%%%%%%%
