%%%%%%%%%%%%
%.%...%..%%%
%....%.o...%
%..........%
%........%%%
%%....%....%
%.....P...%%
%%......%.%%
%........%.%
%.....%....%
%....%....%%
%......%...%
%..G%%..%%.%
%.%..%o%%..%
%..%.......%
%..%%%%%...%
%.....G%%.G%
%.%........%
%%%%%%%%%%%%
