%%%%%%%%%%%%%%
%..%...%.....%
%%..G.%..%..%%
%.......%.%..%
%.........%%.%
%....%....%o%%
%..%%.%..%..%%
%...%........%
%......o.%..G%
%...o...%....%
%....P.%%....%
%%......%..o.%
%o........%%.%
%...%..%.....%
%%........G%.%
%..%%........%
%%%%%%%%%%%%%%
