%%%%%%%%%%%%%
%....%..o...%
%....%..%...%
%%%%.%%.%.%.%
%.......G%..%
%%%.........%
%%...%....%%%
%..%..%.%o%.%
%%%.%....%%.%
%o......G...%
%..o..P%G..%%
%.......%...%
%%%%%%%%%%%%%
