%%%%%%%%%%
%.......%%
%...o....%
%%.%.P%..%
%....%..%%
%......%.%
%.......%%
%..o%....%
%%...%.%G%
%........%
%..o.%...%
%...oo...%
%......%.%
%%%......%
%.%..%...%
%..o.%..G%
%...%....%
%........%
%..o..G..%
%%%%%%%%%%
