%%%%%%%%
%..o..o%
%%.....%
%.%....%
%%..%..%
%..%..o%
%.G...%%
%%%o.%%%
%..%..%%
%%o...P%
%%....o%
%......%
%%..G..%
%..o%..%
%o.....%
%%..%%.%
%%%%%%%%
