%%%%%%%%%%%%%%%
%.........%.o.%
%%%....%...%%.%
%...%.%...%o%.%
%...%.o.......%
%.......%.o.%.%
%..Go..o.o..%.%
%.%...........%
%..%......%.%.%
%...P........o%
%...%o...%....%
%.............%
%%.....o.%..%o%
%%.%o%.....%..%
%%%%%%%%%%%%%%%
