%%%%%%%%%%%
%..%.....o%
%%.....%..%
%.......%.%
%...%%.%..%
%%...%..P.%
%......%%.%
%o....o%%.%
%.%%....%.%
%o.%......%
%.%%..G...%
%%.%.....%%
%%%%%%%%%%%
