%%%%%%%%
%......%
%...%o%%
%%..%..%
%..%..%%
%...P%%%
%%.....%
%..%G%.%
%%..%G%%
%%.....%
%....%.%
%..%.%.%
%.....%%
%%.....%
%%%%%%%%
