%%%%%%%%%%%%%%
%............%
%....%...%%..%
%...%.%......%
%o........%%.%
%o..%...%%%..%
%.........%.o%
%.%..%..%....%
%........%...%
%%.....o..%%.%
%%.........%%%
%.....%.%..oo%
%o.......%.%.%
%...%......%.%
%%%......%...%
%..%.........%
%..o.%%......%
%....%..o....%
%..GPo....o%.%
%%%%%%%%%%%%%%
