%%%%%%%%%%
%....%%..%
%%.%%.o..%
%....o...%
%........%
%%..%.%.%%
%......%.%
%%....%..%
%..%%...o%
%..P...%.%
%......G.%
%.%....G.%
%%....%..%
%%%%%%%%%%
