%%%%%%%%%%%%%
%...........%
%.oo.%...%.P%
%.%....%....%
%......o%...%
%%%G..%.%...%
%..%.....%..%
%...%.%.....%
%...%....%..%
%..%.o%%%...%
%...%.%.%..G%
%%%.....%%G.%
%%%%%%%%%%%%%
