%%%%%%%%%
%...%...%
%..o%..%%
%.......%
%..G....%
%.%.oo..%
%%...%o.%
%......G%
%.......%
%...%...%
%%..P...%
%....%.%%
%%%%%%%%%
