%%%%%%%%%%%%
%..........%
%..%.%..%..%
%.....%....%
%%..G......%
%.%......%.%
%.........%%
%......%..%%
%....P.%...%
%........o.%
%.%.....%.%%
%....o.....%
%....%G%..%%
%......%.%.%
%..o..%...%%
%%%%%%%%%%%%
