%%%%%%%%
%%.....%
%..%...%
%...%..%
%....%%%
%%..G..%
%....%.%
%..%...%
%..%...%
%...o..%
%......%
%..G%.%%
%...%%.%
%....%.%
%..%P..%
%%..o..%
%%%%%%%%
