%%%%%%%%%%%
%..o%.%...%
%.%......%%
%.%.%%o.%.%
%.........%
%%.%..o%%.%
%...%o...%%
%.o.......%
%.%..%.%.P%
%...%.....%
%...%.....%
%.o..%.%..%
%......G%.%
%..%.%..o.%
%...%...%.%
%....%.%.o%
%...%..G..%
%%o.....o.%
%%%%%%%%%%%
