%%%%%%%%
%...%.%%
%...ooG%
%....G.%
%.....P%
%...%..%
%%..G..%
%.%%.%.%
%..%%..%
%......%
%.%%..%%
%%...o.%
%......%
%o..%.%%
%%...%.%
%.%...%%
%...%.%%
%%%%%%%%
