%%%%%%%%%%%%
%....o..%..%
%%%%..%.P.%%
%..%.%.....%
%o.%.......%
%..........%
%...%%..%.%%
%....%%%%.%%
%..%...%%%.%
%.....oGoo.%
%......%o.o%
%.%....%%%.%
%...%...%..%
%.%.%...%..%
%%%%%%%%%%%%
