%%%%%%%%%
%..%%%..%
%%.G....%
%..G.%..%
%.......%
%.......%
%o.%....%
%.......%
%.%%.P..%
%...%...%
%%..%.%.%
%...%...%
%.....%.%
%%%%%...%
%.....%.%
%......%%
%.....%.%
%.%..%..%
%...%...%
%%%%%%%%%
