%%%%%%%
%.%...%
%....%%
%..%..%
%.PG%.%
%.G...%
%%%%%%%
