%%%%%%%%%%%
%%........%
%.P......%%
%.G.......%
%.....%...%
%.......G.%
%%%%%%%%%%%
