%%%%%%%
%...%.%
%..G.G%
%.%...%
%..%%.%
%.....%
%.....%
%.P...%
%.....%
%%%%%%%
