%%%%%%%%%%
%....o...%
%.%.o....%
%...G..%.%
%o.......%
%..%%...%%
%........%
%o.%.%..%%
%..GP....%
%%%%%%%%%%
