%%%%%%%%%%%
%..%....o.%
%...%.....%
%.%...o.GP%
%.%G......%
%%%%%%%%%%%
