%%%%%%%%%%%%
%.%%.%.....%
%..%.....G.%
%%.......%.%
%.%.oG..P..%
%.....%.G..%
%....o..%%.%
%%%%%%%%%%%%
