%%%%%%%%%%
%........%
%...G%...%
%o...P...%
%..G.....%
%%%%%%%%%%
