%%%%%%%%
%o%....%
%..%...%
%%...o.%
%......%
%.G....%
%.....%%
%...%.%%
%.PG...%
%%%%%%%%
