%%%%%%%%%
%....o%%%
%.....GG%
%..P....%
%%%%%%%%%
