%%%%%%%%%%
%....o...%
%%%.o.G..%
%%.......%
%.....P..%
%%%%%%%%%%
