%%%%%%%%
%......%
%...ooG%
%....%.%
%.G....%
%.%....%
%...%..%
%..P..%%
%%%%%%%%
