%%%%%%%%
%%.....%
%....PG%
%.G....%
%%%%%%%%
