%%%%%%%%%%%%
%...%.....%%
%.o..%.%...%
%...%.%.%..%
%.....%%..G%
%.....P....%
%...%.%..G.%
%%%%%%%%%%%%
