%%%%%%
%....%
%%PG.%
%...%%
%%%%%%
