%%%%%%%%%%
%......%o%
%........%
%..PG.o.G%
%%%%%%%%%%
