%%%%%%
%....%
%.GG.%
%.P..%
%%%%%%
