%%%%%%%
%%%%..%
%....o%
%...G.%
%%....%
%..%.P%
%....G%
%.....%
%%%%%%%
