%%%%%%%
%.....%
%..GPG%
%...%%%
%%%%%%%
