%%%%%%
%....%
%o...%
%....%
%%G.G%
%...P%
%%%%%%
