%%%%%%
%..%.%
%....%
%.PG.%
%.G..%
%%%%%%
