%%%%%%%
%....o%
%.....%
%.....%
%..o..%
%.GPo.%
%%.%..%
%..o..%
%%%%%%%
