%%%%%%%%%%%%
%........%.%
%......G...%
%.%...%%..P%
%....o.....%
%.%......%.%
%..%.......%
%..........%
%..%G......%
%%%%%%%%%%%%
