%%%%%%%%%%
%........%
%.G.G....%
%.....P%.%
%%%%%%%%%%
